31
3
  0:0  0:0  0:0  0:0  0:0  0:0  0:0  0:0  0:0  0:0  0:0  0:0  0:0  0:0  0:0  0:0
  0:0  1:4  4:0  4:0  4:0  4:0  4:0  4:0  4:0  4:0  4:0  4:0  4:0  4:0  0:0  0:0
  0:0  2:4  4:0  3:1  4:0  3:2  4:0  3:3  4:0  3:4  4:0  3:5  4:0  4:0  1:2  0:0
  0:0  0:0  4:0  4:0  4:0  4:0  4:0  4:0  4:0  4:0  4:0  4:0  4:0  4:0  2:2  0:0
  0:0  0:0  4:0  3:6  4:0  3:7  4:0  3:8  4:0  3:9  4:0  3:11  4:0  4:0  0:0  0:0
  0:0  0:0  4:0  4:0  4:0  4:0  4:0  4:0  4:0  4:0  4:0  4:0  4:0  4:0  0:0  0:0
  0:0  0:0  4:0  3:12  4:0  3:16  4:0  3:17  4:0  2:3  1:3  0:0  0:0  4:0  0:0  0:0
  0:0  0:0  4:0  4:0  0:0  4:0  4:0  0:0  0:0  0:0  0:0  0:0  0:0  4:0  0:0  0:0
  0:0  0:0  4:0  3:14  4:0  3:15  0:0  0:0  0:0  0:0  0:0  0:0  0:0  4:0  0:0  0:0
  0:0  0:0  4:0  4:0  4:0  0:0  0:0  0:0  0:0  0:0  0:0  0:0  0:0  4:0  0:0  0:0
  0:0  0:0  4:0  3:32  0:0  3:31  0:0  0:0  0:0  0:0  0:0  0:0  0:0  4:0  0:0  0:0
  0:0  0:0  4:0  4:0  4:0  4:0  4:0  4:0  4:0  4:0  4:0  4:0  4:0  4:0  0:0  0:0
  0:0  0:0  1:5  2:5  0:0  0:0  0:0  0:0  0:0  0:0  0:0  2:1  1:1  0:0  0:0  0:0
  0:0  0:0  0:0  0:0  0:0  0:0  0:0  0:0  0:0  0:0  0:0  0:0  0:0  0:0  0:0  0:0
